15 15
222222222222222
2R00000000000G2
200000000000002
200000000000002
2B00000000000Y2
200000000000002
200000000000002
200000000000002
200000000000002
200000000000002
200000000000002
200000000000002
200000000000002
2000000P0000002
222222222222222