15 13
222222222222222
2G00001110000Y2
201110111011102
200000111000002
201010000010102
201010111010102
2000000P0000002
201010111010102
201010000010102
200000111000002
201110111011102
2R00001110000B2
222222222222222