19 13
2222222222222222222
2222222222222222222
200000000P000000002
2010101010101010102
2010101010101010102
2000000000000000002
2110111111111110112
2000000000000000002
2010101RG0BY1010102
2010101111111010102
2000100000000010002
2222222222222222222
2222222222222222222