17 13
22222222222222222
2G0000000000000Y2
20000111111100002
20000000100000002
20000100100100002
20000100000100002
20011110P01111002
20000100000100002
20000100100100002
20000000100000002
20000111111100002
2B0000000000000R2
22222222222222222