17 23
22222222222222222
20000000100000002
20110110101101102
20000000100000002
20101000000010102
20101011111010102
20101000100010102
20101110101110102
20001000000010002
20101011011010102
2010101R0Y1010102
2000000G0B0000002
20101011011010102
20101000000010102
20001011111010002
20101000100010102
20101010101000102
20100010101000102
20101000P00010102
20100001010000102
20111101010111102
20000000000000002
22222222222222222